Lithium - Batteries
Beryllium - Cogs/Aviation
Boron - FIRE POWER/Cleaning (Borax)
Carbon - Hydrocarbons/Strong Fibres/Graphene
Sodium - Sodium Chloride (Salt) / Heat Moderator
Magnesium - Cattle Feed/Fertilisers
Aluminium - Kitchen/Appliances/containers/machines
Silicon - Polymers/Engines/Dynamo-Generators
Phosphorus - Fertilizer/Fire Starting (Matches)
Sulfur - Rubber / Sulfuric Acid
Potassium - From Soil/Agriculture
Calcium - Alloys/Plaster-of-paris
Scandium - Light-strong alloys
Titanium - Strong & Light - human connection
Vanadium - Vanadium-Steel - Strong Shock Resistant
Chromium - Stainless Steel / Shiny
Manganese - Manganese-Steel / STRONK
Cobalt - Magnetic - Strong/nimble when alloyed
Nickel - Alloys STRONK (Bronze etc.)
Copper - Machines and alloys
Zinc - Machines & Alloys
Gallium - Gallium Arsenide - Semiconductors
Germanium - Semiconductors
Arsenic - Poison/Gallium Arsenide - Semiconductors
Selenium - Glass addon/Photovoltaic things
Rubidium - Not Much tbh
Strontium - RED Fireworks/Glow in the dark shizz
Yttrium - Alloy Strengthener/Laser lenses.LED (White)
Zirconium - Nuclear reactive-safe pipes/niobium-zirconium superconductive alloy at low heat
Niobium - ^^^^ / Stronk Alloys low temps
Molybdenum - High Melting point / alloys
Technetium - Technetium-99m gamma-rays / steel corrosion inhibitor
Ruthenium - Chip Resistors / Solar Cells
Rhodium - Reduces emissions / chemical catalyst in acids
Palladium - Jewellery / Ceramic capacitors
Silver - Semi-Precious & Best Reflector EVER
Cadmium - Batteries
Indium - Screens for devices
Tin - alloys & earlier machines
Antimony - Semi conductors - Infrared & diodes
Tellurium - Alloys/  Oil refining catalyst
Iodine - ORANGE BOI - Disinfectant
Cesium - Drilling fluid / GPS / Clocks
Barium - Toxic / Not much else
Cerium - Oven Cleaner / Cerium-Sulfide RED COLOR POG
Praseodymium - STRONK ALLOYS
Neodymium - Such Laser Much Wow
Samarium - Magnet Attraction OOOOOHHH YEEEEEE
Europium - RED LIGHT SHINY POG / MONE
Gadolinium - Alloys
Terbium - xray - BOOM BOOM SPEAKERS
Dysprosium - magnets
Ytterbium - TUNEABLE LASERS EH?
Lutetium - Cracking Hydrocarbons
Hafnium - Alloys
Tantalum - electrical Components
Tungsten - alloys and lights
Osmium - Mek / Thin Stuff - Needles - pens
Iridium - Corrosion Resistant
Platinum - Jewellery / Hard Drives / Screens
Mercury - Thermal measurements
Lead - heavy / alloys / solder
Bismuth - Fire extinguishers / hot machines

